S-########
#--------#
#-###-##-#
#-#----#-#
#-#--#-#-#
#-##-#####
#-#------#
#-#-#-##-#
#####-####
#####----E