S ########
#        #
# ### ## #
# #    # #
# #  # # #
# ## #####
# #      #
# # # ## #
##### ####
#####    E